Year,Australian Open,French Open,Wimbledon,US Open,Total
2003,0,0,0,0,0
2004,0,0,0,0,0
2005,0,0,0,0,0
2006,0,0,0,0,0
2007,0,0,0,0,0
2008,1,0,0,0,1
2009,1,0,0,0,1
2010,1,0,0,0,1
2011,2,0,1,1,4
2012,3,0,1,1,5
2013,4,0,1,1,6
2014,4,0,2,1,7
2015,5,0,3,2,10
2016,6,1,3,2,12
2017,6,1,3,2,12
2018,6,1,4,3,14
2019,7,1,5,3,16
2020,8,1,5,3,17
2021,9,2,6,3,20
2022,9,2,7,3,21
2023,10,3,7,4,24
