Year,Australian Open,French Open,Wimbledon,US Open,Total
2003,0,0,1,0,1
2004,1,0,2,1,4
2005,1,0,3,2,6
2006,2,0,4,3,9
2007,3,0,5,4,12
2008,3,0,5,5,13
2009,3,1,6,5,15
2010,4,1,6,5,16
2011,4,1,6,5,16
2012,4,1,7,5,17
2013,4,1,7,5,17
2014,4,1,7,5,17
2015,4,1,7,5,17
2016,4,1,7,5,17
2017,5,1,8,5,19
2018,6,1,8,5,20
2019,6,1,8,5,20
2020,6,1,8,5,20
2021,6,1,8,5,20
2022,6,1,8,5,20
2023,6,1,8,5,20
