Year,Australian Open,French Open,Wimbledon,US Open,Total
2003,0,0,0,0,0
2004,0,0,0,0,0
2005,0,1,0,0,1
2006,0,2,0,0,2
2007,0,3,0,0,3
2008,0,4,1,0,5
2009,1,4,1,0,6
2010,1,5,2,1,9
2011,1,6,2,1,10
2012,1,7,2,1,11
2013,1,8,2,2,13
2014,1,9,2,2,14
2015,1,9,2,2,14
2016,1,9,2,2,14
2017,1,10,2,3,16
2018,1,11,2,3,17
2019,1,12,2,4,19
2020,1,13,2,4,20
2021,1,13,2,4,20
2022,2,14,2,4,22
2023,2,14,2,4,22
