Year,Australian Open,French Open,Wimbledon,US Open,Total
1974,0,1,0,0,1
1975,0,2,0,0,2
1976,0,2,1,0,3
1977,0,2,2,0,4
1978,0,3,3,0,6
1979,0,4,4,0,8
1980,0,5,5,0,10
1981,0,6,5,0,11
1982,0,6,5,0,11
1983,0,6,5,0,11
1984,0,6,5,0,11
1985,0,6,5,0,11
1986,0,6,5,0,11
1987,0,6,5,0,11
1988,0,6,5,0,11
1989,0,6,5,0,11
1990,0,6,5,0,11
