Year,Australian Open,French Open,Wimbledon,US Open,Total
1985,0,0,0,0,0
1986,0,0,0,0,0
1987,0,0,0,0,0
1988,0,0,0,0,0
1989,0,0,0,0,0
1990,0,0,0,1,1
1991,0,0,0,1,1
1992,0,0,0,1,1
1993,0,0,1,2,3
1994,1,0,2,2,5
1995,1,0,3,3,7
1996,1,0,3,4,8
1997,2,0,4,4,10
1998,2,0,5,4,11
1999,2,0,6,4,12
2000,2,0,7,4,13
2001,2,0,7,4,13
2002,2,0,7,5,14
2003,2,0,7,5,14
